5 5
1 2 4 0 0
0 0 0 0 0
0 1 3 0 0
0 0 0 0 0
3 2 0 0 4