5 5
1 2 0 2 3
0 0 0 0 0
5 0 3 4 0
0 0 0 1 0
0 0 0 5 4