5 5
1 0 2 3 4
4 0 0 0 0
0 0 2 0 0
0 0 1 3 0
0 0 0 0 0