5 5
2 1 0 0 1
0 0 0 0 0
0 0 0 3 2
3 0 0 2 4
2 0 4 0 0