5 5
1 0 0 0 0
3 2 0 2 0
0 0 0 3 1
4 0 0 4 5
5 0 0 0 0