5 5
0 0 0 1 4
0 2 3 4 0
0 0 0 0 0
0 0 0 0 3
0 0 1 0 2