5 5
1 0 0 2 3
0 0 0 4 0
0 0 4 0 0
0 2 3 0 5
0 1 5 0 0